65656565545655454545
67654545655654644545
47654445556454564463
44675544644744565555
65356665555565545466
75445755465445444655
46644665557435455555
45655556446644454644
45456654544554554454
45444554545464566554
44555364563447545545
55454545545454665653
36446365644556355454
54755545455565534444
44564465654647664545
53566546656565655545
64365545564757654643
45546444657566654555
65464735554847556454
55435464644575846534
